111111111111
10010000000C
100001111100
1P0011E00000
111111111111
