1111111111111
1P0C0CE0000C1
1111111111111
