111111111
11111PC01
1111100E1
111111111