1111111111111
1Z010000000C1
1000011111Z01
1P0Z11E0000Z1
1111111111111
