1111111
1P00CA1
1EZ0111
1111111