1111111111111
1ZZZZZZZZZZZ1
1PCCCCCCCCCE1
1ZZZZZZZZZZZ1
1111111111111